#-------------------------------------------------------------------------------------------------------------------------------------------#
|                                                                                                                                           |
|                                                                                                                                           |
|                                                                                                                                           |
|                                                                                                                                           |
|                                               #---------#                                                                                 |
|                                               |         |                                                                                 |
|                                               |         |                                                                                 |
|                                               |         |                                                                                 |
|                                               |         |                                                                                 |
|                                               #---------#                                                                                 |
|                                                                                                                                           |
|                                                                                                                                           |
|                                                                                                                                           |
|                                                                                                                                           |
|                                                                                                                                           |
|                                                                                                                                           |
|                                                                                                                                           |
|                                                                                                                                           |
|                                                                                                                                           |
|                                                                        #---------#                                                        |
|                                                                        |         |                                                        |
|                                                                        |         |                                                        |
|                                                                        |         |                                                        |
|                                                                        |         |                                                        |
|                                                                        #---------#                                                        |
|                                                                                                                                           |
|                                                                                                                                           |
|                                                                                                                                           |
|                                                                                                                                           |
|                                                                                                                                           |
|                                                                                                                                           |
|                                                                                                                                           |
|                                                                                                                                           |
|                                                                                                                                           |
|                                                                                                                                           |
|                                                                                                                                           |
#-------------------------------------------------------------------------------------------------------------------------------------------#