????????????#-----------#??????????????
????????????|           |??????????????
????????????|           |??????????????
????????????|           |??????????????
#-----------#           #-------------#
|                                     |
|                                     |
|                                     |
|                                     |
#----------#           #--------------#
???????????|           |???????????????
???????????|           |???????????????
???????????|           |???????????????
???????????|           |???????????????
???????????#-----------#???????????????